0,0,4,8,0,0,0,1,5
5,9,0,0,0,6,0,0,0
0,0,0,0,0,2,0,0,3
7,2,1,0,0,0,0,3,0
0,3,9,7,0,5,0,0,6
0,0,5,1,0,0,0,0,9
0,0,0,0,0,0,3,7,0
0,8,0,0,0,4,0,0,0
2,0,0,6,5,0,0,0,0
